████████████████████████████████████████████████████████████
██████████████████████ [AUTH SERVICE] ██████████████████████
████████████████████████████████████████████████████████████
           |
           v
████████████████████████████████████████████████████████████
██████████████████████ [USER SERVICE] ██████████████████████
████████████████████████████████████████████████████████████
           |
           v
+-----------------+
|    USER  DB     |
+-----------------+