[ MICROSERVICE MAP ]
--------------------
+-----------+      +-----------+
|  AUTH     | ---> |   USER    |
+-----------+      +-----------+
       |                  |
       v                  v
+-----------+      +-----------+
| TOKENS    |      | USER DB   |
+-----------+      +-----------+